{
    "levels":[
        {
            "map":[
                ["1", "1", "1", "1", "1", "1", "1", "1", "1", "1", "1", "1", "1", "1", "1", "1"],
                ["1", "0", "0", "0", "0", "0", "0", "0", "0", "0", "0", "0", "0", "0", "0", "1"],
                ["1", "0", "0", "3", "3", "3", "3", "0", "0", "0", "2", "2", "2", "0", "0", "1"],
                ["1", "0", "0", "0", "0", "0", "4", "0", "0", "0", "0", "0", "2", "0", "0", "1"],
                ["1", "0", "0", "0", "0", "0", "4", "0", "0", "0", "0", "0", "2", "0", "0", "1"],
                ["1", "0", "0", "3", "3", "3", "3", "0", "0", "0", "0", "0", "0", "0", "0", "1"],
                ["1", "0", "0", "0", "0", "0", "0", "0", "0", "0", "0", "0", "0", "0", "0", "1"],
                ["1", "0", "0", "0", "4", "0", "0", "0", "4", "0", "0", "0", "0", "0", "0", "1"],
                ["1", "1", "1", "3", "1", "3", "1", "1", "1", "3", "0", "0", "3", "1", "1", "1"],
                ["1", "1", "1", "1", "1", "1", "1", "1", "1", "3", "0", "0", "3", "1", "1", "1"],
                ["1", "1", "1", "1", "1", "1", "1", "1", "1", "3", "0", "0", "3", "1", "1", "1"],
                ["1", "1", "3", "1", "1", "1", "1", "1", "1", "3", "0", "0", "3", "1", "1", "1"],
                ["1", "4", "0", "0", "0", "0", "0", "0", "0", "0", "0", "0", "0", "0", "0", "1"],
                ["3", "0", "0", "0", "0", "0", "0", "0", "0", "0", "0", "0", "0", "0", "0", "1"],
                ["1", "0", "0", "0", "0", "0", "0", "0", "0", "0", "0", "0", "0", "0", "0", "1"],
                ["1", "0", "0", "2", "0", "0", "0", "0", "0", "3", "4", "0", "4", "3", "0", "1"],
                ["1", "0", "0", "5", "0", "0", "0", "0", "0", "0", "3", "0", "3", "0", "0", "1"],
                ["1", "0", "0", "2", "0", "0", "0", "0", "0", "0", "0", "0", "0", "0", "0", "1"],
                ["1", "0", "0", "0", "0", "0", "0", "0", "0", "0", "0", "0", "0", "0", "0", "1"],
                ["3", "0", "0", "0", "0", "0", "0", "0", "0", "0", "0", "0", "0", "0", "0", "1"],
                ["1", "4", "0", "0", "0", "0", "0", "0", "4", "0", "0", "4", "0", "0", "0", "1"],
                ["1", "1", "3", "3", "0", "0", "3", "3", "1", "3", "3", "1", "3", "1", "1", "1"],
                ["1", "1", "1", "3", "0", "0", "3", "1", "1", "1", "1", "1", "1", "1", "1", "1"],
                ["1", "3", "3", "4", "0", "0", "4", "3", "3", "3", "3", "3", "3", "3", "3", "1"],
                ["3", "0", "0", "0", "0", "0", "0", "0", "0", "0", "0", "0", "0", "0", "0", "3"],
                ["3", "0", "0", "0", "0", "0", "0", "0", "0", "0", "0", "0", "0", "0", "0", "3"],
                ["3", "0", "0", "0", "0", "0", "0", "0", "0", "0", "0", "0", "0", "0", "0", "3"],
                ["3", "0", "0", "5", "0", "0", "0", "5", "0", "0", "0", "5", "0", "0", "0", "3"],
                ["3", "0", "0", "0", "0", "0", "0", "0", "0", "0", "0", "0", "0", "0", "0", "3"],
                ["3", "0", "0", "0", "0", "0", "0", "0", "0", "0", "0", "0", "0", "0", "0", "3"],
                ["3", "0", "0", "0", "0", "0", "0", "0", "0", "0", "0", "0", "0", "0", "0", "3"],
                ["3", "3", "3", "3", "3", "3", "3", "3", "3", "3", "3", "3", "3", "3", "3", "3"]
            ],
            "objects_anim":{
                "red_light":"14.5,5.5-14.5,7.5-12.5,7.5-9.5,7.5-14.5,12.5-9.5,20.5-10.5,20.5-3.5,14.5-3.5,18.5",
                "green_light":"1.5,1.5-1.5,7.5-5.5,3.25-5.5,4.75-7.5,2.5-7.5,5.5-14.5,1.5-14.5,4.5-14.5,24.5-14.5,30.5-1.5,30.5-1.5,24.5"
            },
            "enemies":20,
            "enemies_weights":[70,20,10]
        }
    ]
}